R  1280 720
NO ./images/bois.xpm
SO ./images/stonks.xpm


WE  ./images/shaggy.xpm
EA ./images/rat.xpm
S  ./images/cursed.xpm
S2  ./images/cursed.xpm

C 0,13,123
F  43     ,43   ,                          43


11111111111111111111111111
11111111111100000000000001
1000001111110000000000001
100000000000000000000001
1N0000000000000000000001
1000001111110000000000001
11110011111100000000000001
11110011111111111111111111
11110011111111111111111111
10000000000000001111111111
10000000000000000000000001
10000000000000001000000001
11110011111111110000000001
10000000000000000000000001
10000000000000000000000001
10000000000000000000000001
10000000000000000000000001
10000000000000000000000001
10000000000000000000000001
11111111111111111111111111
