R  19200 1080
NO ./images/eagle.xpm
SO ./images/wood.xpm
WE ./images/purplestone.xpm
EA ./images/wall.xpm

S  ./images/pillar.xpm
S2  ./images/greenlight.xpm

C  0, 13, 123
F  100, 100, 100

111111111111111111111111111111111111111111111
100000000000000000011111110000000000000000001
102000000000000002011111110000000000000000001
10000000000000000001111111000000000110000000111
100000000E0000000000003000000000002112000000301
10000000000000000001110111000000000110000000101
102000000000000002011101110000000000000000001011
100000000000000000011101110000000000000000001001
111111131111111111111101111111111111111113311131
      101000000000000000000000000000111110011001
      10100002120000000000000212000003000001101
      10000001110000002000000111000003000001101
       1100002120000000000000212000001111111101
        100000000000000000000000000003000000001
11111111111111111111111111111111111111111111111
