R  19200 1080
NO ./images/eagle.xpm
SO ./images/wood.xpm
WE ./images/purplestone.xpm
EA ./images/wall.xpm

S  ./images/pillar.xpm
S2 ./images/greenlight.xpm

C  0, 13, 123
F  100, 100, 100

11111111111111111111
10000000030000000001
10200000000000000201
10000000000000000001
100000000E0000000001
10000000000000000001
10200000000000000201
10000000030000000001
11111111111111111111
