R  19200 1080
NO ./images/eagle.xpm
SO ./images/wood.xpm
WE ./images/purplestone.xpm
EA ./images/wall.xpm

S  ./images/pillar.xpm
S2 ./images/greenlight.xpm

C  0, 13, 123
F  100, 100, 100

111111111111111111111111111111111111111111111
100000000300000000011111110000000000000000001
102000000000000002011111110000000000000000001
10000000000000000001111111000000000110000000111
100000000E0000000000000000000000002112000000001
10000000000000000001110111000000000110000000101
10200000000000000201110111000000000000000000101
10000000030000000001110111000000000000000000101
11111111111111111111110111111111111111111111101
10000000000000000000000000000000000000000000101
10000212000000000000000000000000000021200000101
10000111000000000000002000000000000011100000001
100002120000000000000000000000000000212000001
100000000000000000000000000000000000000000001
111111111111111111111111111111111111111111111
