R  1920 1080
NO ./images/rat.xpm
SO ./images/shaggy.xpm

WE ./images/stonks.xpm
EA ./images/bois.xpm
S  ./images/cursed.xpm
S2 ./images/thonk.xpm

C  0, 13, 123
F  100, 100, 100

11111111111111111111111111
11111111111100000000000001
10000011111102000000000201
10000000000000000000000001
1N000000000000000030000001
10000011111100000000000001
10000010000102000000000201
11110010110100000000000001
11110000010111111111111111
11111111110111111111111111
10000000000000001111111111
10200000000000000000000001
10000000000000001000000201
11110011111111110000000001
10000000000000000000000001
10200000000000000000000001
10000000000000000000000001
10200000000000000000000201
10000000000000000000000001
11111111111111111111111111
