R  1920 1080
NO ./images/eagle.xpm
SO ./images/wood.xpm
WE ./images/purplestone.xpm
EA ./images/wall.xpm
S  ./images/pillar.xpm

S2  ./images/greenlight.xpm
C  0, 13, 123


F  100, 100, 100


111111111111111111111111111111111111111111111
100000000000000000011111110000000000000000001
1020000000000000020111111100000000000000000E1
100000000000000000011111110000000001100000001111
1000000000000000000000300000000000211200000030301
100000000000000000011101110000000001100000001011
10200000000000000201110111000000000000000000101111
1000000000000000000111011100000000000000000010000001
111111131111111111111101111111111111111113311131111
      101000000000000000000000000000111110011001
      10100002120000000000000212000003000001101
      10000001110000002000000111000003000001101
       1100002120000000000000212000001111111101
        100000000000000000000000000003000000001
11111111111111111111111111111111111111111111111
